#################################################
#....s...###..........................#.........#
#........#.#....##..........##........#.........#
#........#......##..........##........#.........#
#........#............................#.........#
#........#............................#.........#
#........#......##..........##........#.........#
#........#......##..........##........#.........#
#........#..................##........#.........#
#@..............................................#
#........#s.................##........#.........#
#........#......##..........##........#.........#
#........#......##..........##........#.........#
#........#............................#.........#
#........#............................#.........#
#........#......##..........##........#.........#
#........#B#....##..........##........#.........#
#....s...###..........................#.........#
#################################################